5 5 10.000000 14.000000 60.000000 1.000000 +-+-+-+-+-+
|S|       |
+ +     + +
|       | |
+   + +-+-+
|   |G|   |
+-+-+-+ +-+
|     |   |
+     +   +
|         |
+-+-+-+-+-+
